/	app.pedidos.views.formulario_cliente	formulario_cliente
/admin/	django.contrib.admin.sites.index	admin:index
/admin/<app_label>/	django.contrib.admin.sites.app_index	admin:app_list
/admin/<url>	django.contrib.admin.sites.catch_all_view
/admin/admin_interface/theme/	django.contrib.admin.options.changelist_view	admin:admin_interface_theme_changelist
/admin/admin_interface/theme/<path:object_id>/	django.views.generic.base.RedirectView
/admin/admin_interface/theme/<path:object_id>/change/	django.contrib.admin.options.change_view	admin:admin_interface_theme_change
/admin/admin_interface/theme/<path:object_id>/delete/	django.contrib.admin.options.delete_view	admin:admin_interface_theme_delete
/admin/admin_interface/theme/<path:object_id>/history/	django.contrib.admin.options.history_view	admin:admin_interface_theme_history
/admin/admin_interface/theme/add/	django.contrib.admin.options.add_view	admin:admin_interface_theme_add
/admin/auth/group/	django.contrib.admin.options.changelist_view	admin:auth_group_changelist
/admin/auth/group/<path:object_id>/	django.views.generic.base.RedirectView
/admin/auth/group/<path:object_id>/change/	django.contrib.admin.options.change_view	admin:auth_group_change
/admin/auth/group/<path:object_id>/delete/	django.contrib.admin.options.delete_view	admin:auth_group_delete
/admin/auth/group/<path:object_id>/history/	django.contrib.admin.options.history_view	admin:auth_group_history
/admin/auth/group/add/	django.contrib.admin.options.add_view	admin:auth_group_add
/admin/autocomplete/	django.contrib.admin.sites.autocomplete_view	admin:autocomplete
/admin/caja/alertastock/	django.contrib.admin.options.changelist_view	admin:caja_alertastock_changelist
/admin/caja/alertastock/<path:object_id>/	django.views.generic.base.RedirectView
/admin/caja/alertastock/<path:object_id>/change/	django.contrib.admin.options.change_view	admin:caja_alertastock_change
/admin/caja/alertastock/<path:object_id>/delete/	django.contrib.admin.options.delete_view	admin:caja_alertastock_delete
/admin/caja/alertastock/<path:object_id>/history/	django.contrib.admin.options.history_view	admin:caja_alertastock_history
/admin/caja/alertastock/add/	django.contrib.admin.options.add_view	admin:caja_alertastock_add
/admin/caja/cierrecaja/	django.contrib.admin.options.changelist_view	admin:caja_cierrecaja_changelist
/admin/caja/cierrecaja/<path:object_id>/	django.views.generic.base.RedirectView
/admin/caja/cierrecaja/<path:object_id>/change/	django.contrib.admin.options.change_view	admin:caja_cierrecaja_change
/admin/caja/cierrecaja/<path:object_id>/delete/	django.contrib.admin.options.delete_view	admin:caja_cierrecaja_delete
/admin/caja/cierrecaja/<path:object_id>/history/	django.contrib.admin.options.history_view	admin:caja_cierrecaja_history
/admin/caja/cierrecaja/add/	django.contrib.admin.options.add_view	admin:caja_cierrecaja_add
/admin/caja/detallepago/	django.contrib.admin.options.changelist_view	admin:caja_detallepago_changelist
/admin/caja/detallepago/<path:object_id>/	django.views.generic.base.RedirectView
/admin/caja/detallepago/<path:object_id>/change/	django.contrib.admin.options.change_view	admin:caja_detallepago_change
/admin/caja/detallepago/<path:object_id>/delete/	django.contrib.admin.options.delete_view	admin:caja_detallepago_delete
/admin/caja/detallepago/<path:object_id>/history/	django.contrib.admin.options.history_view	admin:caja_detallepago_history
/admin/caja/detallepago/add/	django.contrib.admin.options.add_view	admin:caja_detallepago_add
/admin/caja/historialmodificacion/	django.contrib.admin.options.changelist_view	admin:caja_historialmodificacion_changelist
/admin/caja/historialmodificacion/<path:object_id>/	django.views.generic.base.RedirectView
/admin/caja/historialmodificacion/<path:object_id>/change/	django.contrib.admin.options.change_view	admin:caja_historialmodificacion_change
/admin/caja/historialmodificacion/<path:object_id>/delete/	django.contrib.admin.options.delete_view	admin:caja_historialmodificacion_delete
/admin/caja/historialmodificacion/<path:object_id>/history/	django.contrib.admin.options.history_view	admin:caja_historialmodificacion_history
/admin/caja/historialmodificacion/add/	django.contrib.admin.options.add_view	admin:caja_historialmodificacion_add
/admin/caja/transaccion/	django.contrib.admin.options.changelist_view	admin:caja_transaccion_changelist
/admin/caja/transaccion/<path:object_id>/	django.views.generic.base.RedirectView
/admin/caja/transaccion/<path:object_id>/change/	django.contrib.admin.options.change_view	admin:caja_transaccion_change
/admin/caja/transaccion/<path:object_id>/delete/	django.contrib.admin.options.delete_view	admin:caja_transaccion_delete
/admin/caja/transaccion/<path:object_id>/history/	django.contrib.admin.options.history_view	admin:caja_transaccion_history
/admin/caja/transaccion/add/	django.contrib.admin.options.add_view	admin:caja_transaccion_add
/admin/configuracion/configuracionsistema/	django.contrib.admin.options.changelist_view	admin:configuracion_configuracionsistema_changelist
/admin/configuracion/configuracionsistema/<path:object_id>/	django.views.generic.base.RedirectView
/admin/configuracion/configuracionsistema/<path:object_id>/change/	django.contrib.admin.options.change_view	admin:configuracion_configuracionsistema_change
/admin/configuracion/configuracionsistema/<path:object_id>/delete/	django.contrib.admin.options.delete_view	admin:configuracion_configuracionsistema_delete
/admin/configuracion/configuracionsistema/<path:object_id>/history/	django.contrib.admin.options.history_view	admin:configuracion_configuracionsistema_history
/admin/configuracion/configuracionsistema/add/	django.contrib.admin.options.add_view	admin:configuracion_configuracionsistema_add
/admin/inventario/categoriainsumo/	django.contrib.admin.options.changelist_view	admin:inventario_categoriainsumo_changelist
/admin/inventario/categoriainsumo/<path:object_id>/	django.views.generic.base.RedirectView
/admin/inventario/categoriainsumo/<path:object_id>/change/	django.contrib.admin.options.change_view	admin:inventario_categoriainsumo_change
/admin/inventario/categoriainsumo/<path:object_id>/delete/	django.contrib.admin.options.delete_view	admin:inventario_categoriainsumo_delete
/admin/inventario/categoriainsumo/<path:object_id>/history/	django.contrib.admin.options.history_view	admin:inventario_categoriainsumo_history
/admin/inventario/categoriainsumo/add/	django.contrib.admin.options.add_view	admin:inventario_categoriainsumo_add
/admin/inventario/insumo/	django.contrib.admin.options.changelist_view	admin:inventario_insumo_changelist
/admin/inventario/insumo/<path:object_id>/	django.views.generic.base.RedirectView
/admin/inventario/insumo/<path:object_id>/change/	django.contrib.admin.options.change_view	admin:inventario_insumo_change
/admin/inventario/insumo/<path:object_id>/delete/	django.contrib.admin.options.delete_view	admin:inventario_insumo_delete
/admin/inventario/insumo/<path:object_id>/history/	django.contrib.admin.options.history_view	admin:inventario_insumo_history
/admin/inventario/insumo/add/	django.contrib.admin.options.add_view	admin:inventario_insumo_add
/admin/inventario/movimientoinsumo/	django.contrib.admin.options.changelist_view	admin:inventario_movimientoinsumo_changelist
/admin/inventario/movimientoinsumo/<path:object_id>/	django.views.generic.base.RedirectView
/admin/inventario/movimientoinsumo/<path:object_id>/change/	django.contrib.admin.options.change_view	admin:inventario_movimientoinsumo_change
/admin/inventario/movimientoinsumo/<path:object_id>/delete/	django.contrib.admin.options.delete_view	admin:inventario_movimientoinsumo_delete
/admin/inventario/movimientoinsumo/<path:object_id>/history/	django.contrib.admin.options.history_view	admin:inventario_movimientoinsumo_history
/admin/inventario/movimientoinsumo/add/	django.contrib.admin.options.add_view	admin:inventario_movimientoinsumo_add
/admin/jsi18n/	django.contrib.admin.sites.i18n_javascript	admin:jsi18n
/admin/login/	django.contrib.admin.sites.login	admin:login
/admin/logout/	django.contrib.admin.sites.logout	admin:logout
/admin/mesas/mesa/	django.contrib.admin.options.changelist_view	admin:mesas_mesa_changelist
/admin/mesas/mesa/<path:object_id>/	django.views.generic.base.RedirectView
/admin/mesas/mesa/<path:object_id>/change/	django.contrib.admin.options.change_view	admin:mesas_mesa_change
/admin/mesas/mesa/<path:object_id>/delete/	django.contrib.admin.options.delete_view	admin:mesas_mesa_delete
/admin/mesas/mesa/<path:object_id>/history/	django.contrib.admin.options.history_view	admin:mesas_mesa_history
/admin/mesas/mesa/add/	django.contrib.admin.options.add_view	admin:mesas_mesa_add
/admin/password_change/	django.contrib.admin.sites.password_change	admin:password_change
/admin/password_change/done/	django.contrib.admin.sites.password_change_done	admin:password_change_done
/admin/pedidos/detallepedido/	django.contrib.admin.options.changelist_view	admin:pedidos_detallepedido_changelist
/admin/pedidos/detallepedido/<path:object_id>/	django.views.generic.base.RedirectView
/admin/pedidos/detallepedido/<path:object_id>/change/	django.contrib.admin.options.change_view	admin:pedidos_detallepedido_change
/admin/pedidos/detallepedido/<path:object_id>/delete/	django.contrib.admin.options.delete_view	admin:pedidos_detallepedido_delete
/admin/pedidos/detallepedido/<path:object_id>/history/	django.contrib.admin.options.history_view	admin:pedidos_detallepedido_history
/admin/pedidos/detallepedido/add/	django.contrib.admin.options.add_view	admin:pedidos_detallepedido_add
/admin/pedidos/pedido/	django.contrib.admin.options.changelist_view	admin:pedidos_pedido_changelist
/admin/pedidos/pedido/<path:object_id>/	django.views.generic.base.RedirectView
/admin/pedidos/pedido/<path:object_id>/change/	django.contrib.admin.options.change_view	admin:pedidos_pedido_change
/admin/pedidos/pedido/<path:object_id>/delete/	django.contrib.admin.options.delete_view	admin:pedidos_pedido_delete
/admin/pedidos/pedido/<path:object_id>/history/	django.contrib.admin.options.history_view	admin:pedidos_pedido_history
/admin/pedidos/pedido/add/	django.contrib.admin.options.add_view	admin:pedidos_pedido_add
/admin/productos/categoria/	django.contrib.admin.options.changelist_view	admin:productos_categoria_changelist
/admin/productos/categoria/<path:object_id>/	django.views.generic.base.RedirectView
/admin/productos/categoria/<path:object_id>/change/	django.contrib.admin.options.change_view	admin:productos_categoria_change
/admin/productos/categoria/<path:object_id>/delete/	django.contrib.admin.options.delete_view	admin:productos_categoria_delete
/admin/productos/categoria/<path:object_id>/history/	django.contrib.admin.options.history_view	admin:productos_categoria_history
/admin/productos/categoria/add/	django.contrib.admin.options.add_view	admin:productos_categoria_add
/admin/productos/producto/	django.contrib.admin.options.changelist_view	admin:productos_producto_changelist
/admin/productos/producto/<path:object_id>/	django.views.generic.base.RedirectView
/admin/productos/producto/<path:object_id>/change/	django.contrib.admin.options.change_view	admin:productos_producto_change
/admin/productos/producto/<path:object_id>/delete/	django.contrib.admin.options.delete_view	admin:productos_producto_delete
/admin/productos/producto/<path:object_id>/history/	django.contrib.admin.options.history_view	admin:productos_producto_history
/admin/productos/producto/add/	django.contrib.admin.options.add_view	admin:productos_producto_add
/admin/r/<int:content_type_id>/<path:object_id>/	django.contrib.contenttypes.views.shortcut	admin:view_on_site
/admin/reportes/reporteventas/	app.reportes.admin.changelist_view	admin:reportes_reporteventas_changelist
/admin/reportes/reporteventas/<path:object_id>/	django.views.generic.base.RedirectView
/admin/reportes/reporteventas/<path:object_id>/change/	django.contrib.admin.options.change_view	admin:reportes_reporteventas_change
/admin/reportes/reporteventas/<path:object_id>/delete/	django.contrib.admin.options.delete_view	admin:reportes_reporteventas_delete
/admin/reportes/reporteventas/<path:object_id>/history/	django.contrib.admin.options.history_view	admin:reportes_reporteventas_history
/admin/reportes/reporteventas/add/	django.contrib.admin.options.add_view	admin:reportes_reporteventas_add
/admin/reservas/reserva/	django.contrib.admin.options.changelist_view	admin:reservas_reserva_changelist
/admin/reservas/reserva/<path:object_id>/	django.views.generic.base.RedirectView
/admin/reservas/reserva/<path:object_id>/change/	django.contrib.admin.options.change_view	admin:reservas_reserva_change
/admin/reservas/reserva/<path:object_id>/delete/	django.contrib.admin.options.delete_view	admin:reservas_reserva_delete
/admin/reservas/reserva/<path:object_id>/history/	django.contrib.admin.options.history_view	admin:reservas_reserva_history
/admin/reservas/reserva/add/	django.contrib.admin.options.add_view	admin:reservas_reserva_add
/admin/sites/site/	django.contrib.admin.options.changelist_view	admin:sites_site_changelist
/admin/sites/site/<path:object_id>/	django.views.generic.base.RedirectView
/admin/sites/site/<path:object_id>/change/	django.contrib.admin.options.change_view	admin:sites_site_change
/admin/sites/site/<path:object_id>/delete/	django.contrib.admin.options.delete_view	admin:sites_site_delete
/admin/sites/site/<path:object_id>/history/	django.contrib.admin.options.history_view	admin:sites_site_history
/admin/sites/site/add/	django.contrib.admin.options.add_view	admin:sites_site_add
/admin/usuarios/usuario/	django.contrib.admin.options.changelist_view	admin:usuarios_usuario_changelist
/admin/usuarios/usuario/<id>/password/	django.contrib.auth.admin.user_change_password	admin:auth_user_password_change
/admin/usuarios/usuario/<path:object_id>/	django.views.generic.base.RedirectView
/admin/usuarios/usuario/<path:object_id>/change/	django.contrib.admin.options.change_view	admin:usuarios_usuario_change
/admin/usuarios/usuario/<path:object_id>/delete/	django.contrib.admin.options.delete_view	admin:usuarios_usuario_delete
/admin/usuarios/usuario/<path:object_id>/history/	django.contrib.admin.options.history_view	admin:usuarios_usuario_history
/admin/usuarios/usuario/add/	django.contrib.auth.admin.add_view	admin:usuarios_usuario_add
/adminux/	app.adminux.views.adminux_dashboard	adminux:dashboard
/adminux/categorias/	app.adminux.views.categorias_list	adminux:categorias
/adminux/categorias/<int:pk>/editar/	app.adminux.views.categorias_editar	adminux:categoria_editar
/adminux/categorias/<int:pk>/eliminar/	app.adminux.views.categorias_eliminar	adminux:categoria_eliminar
/adminux/categorias/crear/	app.adminux.views.categorias_crear	adminux:categoria_crear
/adminux/configuracion/	app.adminux.views.configuracion	adminux:configuracion
/adminux/inventario/categorias/	app.inventario.views.categorias_insumo_list	inventario:categorias_insumo
/adminux/inventario/categorias/<int:pk>/editar/	app.inventario.views.categorias_insumo_editar	inventario:categoria_insumo_editar
/adminux/inventario/categorias/<int:pk>/eliminar/	app.inventario.views.categorias_insumo_eliminar	inventario:categoria_insumo_eliminar
/adminux/inventario/categorias/nuevo/	app.inventario.views.categorias_insumo_crear	inventario:categoria_insumo_crear
/adminux/inventario/insumos/	app.inventario.views.insumos_list	inventario:insumos
/adminux/inventario/insumos/<int:pk>/ajustar/	app.inventario.views.insumos_ajustar_stock	inventario:insumo_ajustar
/adminux/inventario/insumos/<int:pk>/editar/	app.inventario.views.insumos_editar	inventario:insumo_editar
/adminux/inventario/insumos/<int:pk>/eliminar/	app.inventario.views.insumos_eliminar	inventario:insumo_eliminar
/adminux/inventario/insumos/nuevo/	app.inventario.views.insumos_crear	inventario:insumo_crear
/adminux/inventario/movimientos/	app.inventario.views.movimientos_list	inventario:movimientos
/adminux/login/	app.adminux.views.staff_login	adminux:login
/adminux/mesas/	app.adminux.views.mesas_list	adminux:mesas
/adminux/mesas/<int:pk>/editar/	app.adminux.views.mesas_editar	adminux:mesa_editar
/adminux/mesas/<int:pk>/eliminar/	app.adminux.views.mesas_eliminar	adminux:mesa_eliminar
/adminux/mesas/crear/	app.adminux.views.mesas_crear	adminux:mesa_crear
/adminux/pedidos/	app.adminux.views.pedidos_list	adminux:pedidos
/adminux/pedidos/<int:pk>/	app.adminux.views.pedidos_detalle	adminux:pedido_detalle
/adminux/productos/	app.adminux.views.productos_list	adminux:productos
/adminux/productos/<int:pk>/editar/	app.adminux.views.productos_editar	adminux:producto_editar
/adminux/productos/<int:pk>/eliminar/	app.adminux.views.productos_eliminar	adminux:producto_eliminar
/adminux/productos/crear/	app.adminux.views.productos_crear	adminux:producto_crear
/adminux/reportes/	app.adminux.views.reportes	adminux:reportes
/adminux/reportes/productos/	app.adminux.views.reportes_productos	adminux:reportes_productos
/adminux/reportes/ventas/	app.adminux.views.reportes_ventas	adminux:reportes_ventas
/adminux/reservas/	app.adminux.views.reservas_list	adminux:reservas
/adminux/reservas/<int:pk>/editar/	app.adminux.views.reservas_editar	adminux:reserva_editar
/adminux/reservas/<int:pk>/eliminar/	app.adminux.views.reservas_eliminar	adminux:reserva_eliminar
/adminux/reservas/crear/	app.adminux.views.reservas_crear	adminux:reserva_crear
/adminux/usuarios/	app.adminux.views.usuarios_list	adminux:usuarios
/adminux/usuarios/<int:pk>/editar/	app.adminux.views.usuarios_editar	adminux:usuario_editar
/adminux/usuarios/<int:pk>/eliminar/	app.adminux.views.usuarios_eliminar	adminux:usuario_eliminar
/adminux/usuarios/<int:pk>/generar-qr/	app.adminux.views.usuario_generar_qr	adminux:usuario_generar_qr
/adminux/usuarios/crear/	app.adminux.views.usuarios_crear	adminux:usuario_crear
/api/caja/alertas-stock/	app.caja.api_views.api_alertas_stock	caja_api:alertas_stock
/api/caja/alertas-stock/<int:alerta_id>/resolver/	app.caja.api_views.api_resolver_alerta_stock	caja_api:resolver_alerta
/api/caja/empleados/	app.caja.api_views.api_lista_empleados	caja_api:lista_empleados
/api/caja/estadisticas/	app.caja.api_views.api_estadisticas_dia	caja_api:estadisticas
/api/caja/jornada/	app.caja.api_views.api_jornada_estado	caja_api:jornada_estado
/api/caja/jornada/finalizar/	app.caja.api_views.api_jornada_finalizar	caja_api:jornada_finalizar
/api/caja/jornada/iniciar/	app.caja.api_views.api_jornada_iniciar	caja_api:jornada_iniciar
/api/caja/mapa-mesas/	app.caja.api_views.api_mapa_mesas	caja_api:mapa_mesas
/api/caja/pago/mixto/	app.caja.api_views.api_procesar_pago_mixto	caja_api:procesar_pago_mixto
/api/caja/pago/simple/	app.caja.api_views.api_procesar_pago_simple	caja_api:procesar_pago_simple
/api/caja/pedidos/<int:pedido_id>/	app.caja.api_views.api_detalle_pedido	caja_api:detalle_pedido
/api/caja/pedidos/<int:pedido_id>/cambiar-estado/	app.caja.api_views.api_cambiar_estado_pedido	caja_api:cambiar_estado
/api/caja/pedidos/<int:pedido_id>/historial/	app.caja.api_views.api_historial_modificaciones	caja_api:historial_modificaciones
/api/caja/pedidos/agregar-producto/	app.caja.api_views.api_agregar_producto_pedido	caja_api:agregar_producto
/api/caja/pedidos/descuento/	app.caja.api_views.api_aplicar_descuento	caja_api:aplicar_descuento
/api/caja/pedidos/detalle/<int:detalle_id>/cantidad/	app.caja.api_views.api_modificar_cantidad_producto	caja_api:modificar_cantidad
/api/caja/pedidos/detalle/<int:detalle_id>/eliminar/	app.caja.api_views.api_eliminar_producto_pedido	caja_api:eliminar_producto
/api/caja/pedidos/kanban/	app.caja.api_views.api_pedidos_kanban	caja_api:pedidos_kanban
/api/caja/pedidos/pagados/	app.caja.api_views.api_pedidos_pagados	caja_api:pedidos_pagados
/api/caja/pedidos/pendientes/	app.caja.api_views.api_pedidos_pendientes_pago	caja_api:pedidos_pendientes
/api/caja/pedidos/propina/	app.caja.api_views.api_aplicar_propina	caja_api:aplicar_propina
/api/caja/pedidos/reasignar-mesa/	app.caja.api_views.api_reasignar_pedido_mesa	caja_api:reasignar_mesa
/api/caja/turno/abrir/	app.caja.api_views.api_abrir_caja	caja_api:abrir_turno
/api/caja/turno/cerrar/	app.caja.api_views.api_cerrar_caja	caja_api:cerrar_turno
/api/mesas/	app.mesas.views.MesaListCreateView	lista-mesas
/api/pedidos/	rest_framework.routers.APIRootView	api-root
/api/pedidos/<drf_format_suffix:format>	rest_framework.routers.APIRootView	api-root
/api/pedidos/<int:pedido_id>/actualizar/	app.pedidos.views.actualizar_estado_pedido	actualizar_estado
/api/pedidos/<int:pedido_id>/actualizar/	app.pedidos.views.actualizar_estado_pedido	actualizar_estado
/api/pedidos/<int:pedido_id>/eliminar-producto/<int:producto_id>/	app.pedidos.views.eliminar_producto_pedido_api	eliminar_producto_pedido
/api/pedidos/<int:pedido_id>/entregar/	app.pedidos.views.marcar_entregado	marcar_entregado
/api/pedidos/<int:pedido_id>/entregar/	app.pedidos.views.marcar_entregado	marcar_entregado
/api/pedidos/<int:pedido_id>/modificar/	app.pedidos.views.modificar_pedido_api	modificar_pedido
/api/pedidos/<int:pedido_id>/resumen-modificacion/	app.pedidos.views.resumen_modificacion_pedido_api	resumen_modificacion_pedido
/api/pedidos/cliente/crear/	app.pedidos.views.crear_pedido_cliente	crear_pedido_cliente
/api/pedidos/cliente/crear/	app.pedidos.views.crear_pedido_cliente	crear_pedido_cliente
/api/pedidos/cocina/	app.pedidos.views.pedidos_en_cocina_api	pedidos_cocina
/api/pedidos/cocina/	app.pedidos.views.pedidos_en_cocina_api	pedidos_cocina
/api/pedidos/mesero/	app.pedidos.views.pedidos_por_mesa	pedidos_mesero
/api/pedidos/mesero/	app.pedidos.views.pedidos_por_mesa	pedidos_mesero
/api/pedidos/mesero/asignar-mesa/<int:reserva_id>/	app.pedidos.views.api_asignar_mesa_reserva	api_asignar_mesa_reserva
/api/pedidos/mesero/cambiar-estado-reserva/<int:reserva_id>/	app.pedidos.views.api_cambiar_estado_reserva	api_cambiar_estado_reserva
/api/pedidos/mesero/confirmar-reserva/<int:reserva_id>/	app.pedidos.views.api_confirmar_reserva	api_confirmar_reserva
/api/pedidos/mesero/entregar/<int:pedido_id>/	app.pedidos.views.api_entregar_pedido	api_entregar_pedido
/api/pedidos/mesero/mapa-mesas/	app.pedidos.views.mapa_mesas_mesero	mapa_mesas_mesero
/api/pedidos/mesero/pedidos/	app.pedidos.views.api_pedidos_mesero	api_pedidos_mesero
/api/pedidos/mesero/reservas/	app.pedidos.views.api_reservas_mesero	api_reservas_mesero
/api/pedidos/pedidos/	app.pedidos.views.PedidoViewSet	pedido-list
/api/pedidos/pedidos/<pk>/	app.pedidos.views.PedidoViewSet	pedido-detail
/api/pedidos/pedidos/<pk>\.<format>/	app.pedidos.views.PedidoViewSet	pedido-detail
/api/pedidos/pedidos\.<format>/	app.pedidos.views.PedidoViewSet	pedido-list
/api/productos/	app.productos.views.lista_productos	lista_productos
/api/productos/agrupados/	app.productos.views.productos_agrupados	productos_agrupados
/api/refresh/	rest_framework_simplejwt.views.TokenRefreshView	token_refresh
/api/reportes/api/productos-top/	app.reportes.views.datos_productos_top	reportes_api:api_productos_top
/api/reportes/api/ventas-semanales/	app.reportes.views.datos_ventas_semanales	reportes_api:api_ventas_semanales
/api/reportes/dashboard/	app.reportes.views.dashboard_reportes	reportes_api:dashboard
/api/reportes/pdf/	app.reportes.views.generar_reporte_pdf	reportes_api:reporte_pdf
/api/reservas/	app.reservas.views.reservar_mesa	reservar_mesa
/api/reservas/api/cambiar-estado/<int:reserva_id>/	app.reservas.views.cambiar_estado_reserva	cambiar_estado_reserva
/api/reservas/api/cancelar/<int:reserva_id>/	app.reservas.views.cancelar_reserva	cancelar_reserva
/api/reservas/api/mesas-disponibles/	app.reservas.views.mesas_disponibles	mesas_disponibles
/api/reservas/confirmacion/<int:reserva_id>/	app.reservas.views.confirmacion_reserva	confirmacion_reserva
/api/reservas/consultar/	app.reservas.views.consultar_reserva	consultar_reserva
/api/reservas/editar/<int:reserva_id>/	app.reservas.views.editar_reserva	editar_reserva
/api/reservas/panel/	app.reservas.views.panel_reservas	panel_reservas
/api/usuarios/auth-qr/<uuid:token>/	app.usuarios.views.auth_qr	api_usuarios:auth_qr
/api/usuarios/generar-qr/	app.usuarios.views.generar_qr_empleado	api_usuarios:generar_qr
/api/usuarios/lista-qr/	app.usuarios.views.listar_empleados_qr	api_usuarios:lista_qr
/api/usuarios/login-admin/	app.usuarios.views.login_admin	api_usuarios:login_admin
/api/usuarios/login-pin/	app.usuarios.views.login_pin	api_usuarios:login_pin
/api/usuarios/login/	app.usuarios.views.CustomTokenObtainPairView	api_usuarios:api_login
/api/usuarios/logout/	app.usuarios.views.session_logout	api_usuarios:session_logout
/api/usuarios/qr-login/<uuid:token>/	app.usuarios.views.qr_login	api_usuarios:qr_login
/api/usuarios/qr/	app.usuarios.views.ver_qr_simple	api_usuarios:qr_simple
/api/usuarios/registro/	app.usuarios.views.RegistroUsuarioView	api_usuarios:registro_usuario
/api/usuarios/session-login/	app.usuarios.views.session_login	api_usuarios:session_login
/api/usuarios/ver-qr/	app.usuarios.views.ver_todos_qr	api_usuarios:ver_qr
/caja/	app.caja.views.panel_unificado	caja:panel_caja
/caja/abrir/	app.caja.views.abrir_caja	caja:abrir_caja
/caja/cerrar/	app.caja.views.cierre_caja	caja:cierre_caja
/caja/panel/	app.caja.views.panel_unificado	caja:panel_unificado
/caja/personal/generar-qr/<int:empleado_id>/	app.caja.views.generar_qr_empleado	caja:generar_qr_empleado
/cocina/	app.pedidos.views.panel_cocina	panel_cocina
/confirmacion/	app.pedidos.views.confirmacion_pedido	confirmacion_pedido
/empleado/	app.usuarios.views_empleado.panel_empleado	panel_empleado
/exito/	app.pedidos.views.vista_exito	vista_exito
/favicon.ico	django.views.generic.base.RedirectView
/health/	backend.healthcheck.healthcheck	healthcheck
/i18n/setlang/	django.views.i18n.set_language	set_language
/login/	django.views.generic.base.TemplateView	login
/media/<path>	django.views.static.serve
/menu/	app.pedidos.views.formulario_cliente	menu_cliente
/mesero/	app.pedidos.views.panel_mesero	panel_mesero
/qr-login/<uuid:token>/	app.usuarios.views.qr_login	qr_login
/reportes/api/productos-top/	app.reportes.views.datos_productos_top	reportes_web:api_productos_top
/reportes/api/ventas-semanales/	app.reportes.views.datos_ventas_semanales	reportes_web:api_ventas_semanales
/reportes/dashboard/	app.reportes.views.dashboard_reportes	reportes_web:dashboard
/reportes/pdf/	app.reportes.views.generar_reporte_pdf	reportes_web:reporte_pdf
/reservas/	app.reservas.views.reservar_mesa	reservar_mesa
/reservas/api/cambiar-estado/<int:reserva_id>/	app.reservas.views.cambiar_estado_reserva	cambiar_estado_reserva
/reservas/api/cancelar/<int:reserva_id>/	app.reservas.views.cancelar_reserva	cancelar_reserva
/reservas/api/mesas-disponibles/	app.reservas.views.mesas_disponibles	mesas_disponibles
/reservas/confirmacion/<int:reserva_id>/	app.reservas.views.confirmacion_reserva	confirmacion_reserva
/reservas/consultar/	app.reservas.views.consultar_reserva	consultar_reserva
/reservas/editar/<int:reserva_id>/	app.reservas.views.editar_reserva	editar_reserva
/reservas/panel/	app.reservas.views.panel_reservas	panel_reservas
/staff/login/	app.adminux.views.staff_login	staff_login
/static/<path>	django.views.static.serve
/usuarios/auth-qr/<uuid:token>/	app.usuarios.views.auth_qr	usuarios:auth_qr
/usuarios/generar-qr/	app.usuarios.views.generar_qr_empleado	usuarios:generar_qr
/usuarios/lista-qr/	app.usuarios.views.listar_empleados_qr	usuarios:lista_qr
/usuarios/login-admin/	app.usuarios.views.login_admin	usuarios:login_admin
/usuarios/login-pin/	app.usuarios.views.login_pin	usuarios:login_pin
/usuarios/login/	app.usuarios.views.CustomTokenObtainPairView	usuarios:api_login
/usuarios/logout/	app.usuarios.views.session_logout	usuarios:session_logout
/usuarios/qr-login/<uuid:token>/	app.usuarios.views.qr_login	usuarios:qr_login
/usuarios/qr/	app.usuarios.views.ver_qr_simple	usuarios:qr_simple
/usuarios/registro/	app.usuarios.views.RegistroUsuarioView	usuarios:registro_usuario
/usuarios/session-login/	app.usuarios.views.session_login	usuarios:session_login
/usuarios/ver-qr/	app.usuarios.views.ver_todos_qr	usuarios:ver_qr
